%%%%%%%%%%
%       P%
%%%%%%%%%%
